##############
@@@@##########
###@##########
###@@@@@######
#######@######
####@@@@######
####@#########
####@##@@@####
####@##@#@####
####@@@@#@####
#########@####
#########@@###
##@@######@@@@
##############